NO textures/simonkraft/respawn_anchor_side0.xpm
EA textures/simonkraft/respawn_anchor_side2.xpm
SO textures/simonkraft/respawn_anchor_side4.xpm
WE textures/simonkraft/respawn_anchor_side3.xpm

C 35,19,73
F 15,6,40

111111111111111
111111000111111
111110000011111
111100010001111
111000000000111
110000000000011
1E0000000000001
110000000000011
111000010000111
111100000001111
111110000011111
111111000111111
111111111111111
